АБОНЕМЕНТ — АБОНЕНТ
АВТОРИТАРНЫЙ — АВТОРИТЕТНЫЙ
АДРЕСАНТ-АДРЕСАТ
АРТИСТИЧЕСКИЙ — АРТИСТИЧНЫЙ
БЕДНЫЙ — БЕДСТВЕННЫЙ
БЕЗЛИКИЙ — БЕЗЛИЧНЫЙ                      
БЕЗОТВЕТНЫЙ — БЕЗОТВЕТСТВЕННЫЙ
БОЛОТИСТЫЙ — БОЛОТНЫЙ
БЛАГОДАРНЫЙ — БЛАГОДАРСТВЕННЫЙ
БЛАГОТВОРИТЕЛЬНЫЙ — БЛАГОТВОРНЫЙ
БУДНИЙ — БУДНИЧНЫЙ
БЫВАЛЫЙ — БЫВШИЙ — БЫЛОЙ
ВАННА — ВАННАЯ
ВДОХ — ВЗДОХ
ВЕКОВОЙ — ВЕЧНЫЙ
ВЕЛИКИЙ — ВЕЛИЧАВЫЙ — ВЕЛИЧЕСТВЕННЫЙ
ВЕЛИЧИЕ — ВЕЛИЧИНА
ВОЗБУЖДАТЬ — ПОБУЖДАТЬ 
ВОСПОЛНИТЬ — ДОПОЛНИТЬ — ЗАПОЛНИТЬ — НАПОЛНИТЬ — ПЕРЕПОЛНИТЬ —ПОПОЛНИТЬ;
ВРАЖДЕБНЫЙ — ВРАЖЕСКИЙ
ВЫБИРАТЬ — ИЗБИРАТЬ;
ВЫГОДА — ВЫГОДНОСТЬ
ВЫДАЧА — ОТДАЧА — ПЕРЕДАЧА — РАЗДАЧА
ВЫПЛАТА — ОПЛАТА — ПЛАТА — УПЛАТА
ВЫПЛАТИТЬ — ЗАПЛАТИТЬ — ОПЛАТИТЬ — ОТПЛАТИТЬ — УПЛАТИТЬ
ВЫРАСТИТЬ — НАРАСТИТЬ — ОТРАСТИТЬ
ВЫРАЩИВАНИЕ — НАРАЩИВАНИЕ — ОТРАЩИВАНИЕ
ВЫСОКИЙ — ВЫСОТНЫЙ
ГАРАНТИЙНЫЙ — ГАРАНТИРОВАННЫЙ
ГАРМОНИЧЕСКИЙ — ГАРМОНИЧНЫЙ
ГЛИНИСТЫЙ — ГЛИНЯНЫЙ
ГОДИЧНЫЙ — ГОДОВАЛЫЙ — ГОДОВОЙ
ГОРДОСТЬ — ГОРДЫНЯ
ГУМАНИЗМ — ГУМАННОСТЬ
ГУМАНИСТИЧЕСКИЙ — ГУМАНИТАРНЫЙ — ГУМАННЫЙ
ДВОИЧНЫЙ — ДВОЙНОЙ — ДВОЙСТВЕННЫЙ — ДВОЯКИЙ — СДВОЕННЫЙ – УДВОЕННЫЙ
ДЕЙСТВЕННЫЙ — ДЕЙСТВИТЕЛЬНЫЙ — ДЕЙСТВУЮЩИЙ
ДЕЛОВИТЫЙ — ДЕЛОВОЙ — ДЕЛЬНЫЙ — ДЕЛЯЧЕСКИЙ
ДЕМОКРАТИЧНЫЙ — ДЕМОКРАТИЧЕСКИЙ
ДИПЛОМАНТ — ДИПЛОМАТ
ДИПЛОМАТИЧЕСКИЙ — ДИПЛОМАТИЧНЫЙ
ДЛИННЫЙ — ДЛИТЕЛЬНЫЙ
ДОБРОТНЫЙ — ДОБРЫЙ
ДОВЕРИТЕЛЬНЫЙ — ДОВЕРЧИВЫЙ
ДОЖДЕВОЙ — ДОЖДЛИВЫЙ
ДРАМАТИЧЕСКИЙ — ДРАМАТИЧНЫЙ
ДРУЖЕСКИЙ — ДРУЖЕСТВЕННЫЙ — ДРУЖНЫЙ
ЕДИНИЧНЫЙ — ЕДИНСТВЕННЫЙ — ЕДИНЫЙ — ОДИНОЧНЫЙ 
ЖЕЛАННЫЙ — ЖЕЛАТЕЛЬНЫЙ
ЖЕСТОКИЙ — ЖЁСТКИЙ
ЖИЗНЕННЫЙ — ЖИТЕЙСКИЙ
ЖИЛИЩНЫЙ — ЖИЛОЙ
ЗАГОРОДИТЬ — ОГОРОДИТЬ — ОГРАДИТЬ — ОТГОРОДИТЬ — ПЕРЕГОРОДИТЬ
ЗАНИЗИТЬ — ПОНИЗИТЬ — СНИЗИТЬ
ЗАЧИНАТЕЛЬ — ЗАЧИНЩИК
ЗВЕРИНЫЙ — ЗВЕРСКИЙ
ЗВУКОВОЙ — ЗВУЧНЫЙ
ЗЕМЛИСТЫЙ — ЗЕМЛЯНОЙ — ЗЕМНОЙ 
ЗРИТЕЛЬНЫЙ — ЗРИТЕЛЬСКИЙ
ИЗОБРЕТАТЕЛЬНЫЙ — ИЗОБРЕТАТЕЛЬСКИЙ
ИНФОРМАТИВНЫЙ — ИНФОРМАЦИОННЫЙ
ИНФОРМАЦИЯ — ИНФОРМИРОВАННОСТЬ
ИРОНИЧЕСКИЙ — ИРОНИЧНЫЙ
ИСКУСНЫЙ — ИСКУССТВЕННЫЙ
ИСПОЛНИТЕЛЬНЫЙ — ИСПОЛНИТЕЛЬСКИЙ
ИСХОДНЫЙ — ИСХОДЯЩИЙ
КАМЕНИСТЫЙ — КАМЕННЫЙ
КОМФОРТАБЕЛЬНЫЙ — КОМФОРТНЫЙ
КОННЫЙ — КОНСКИЙ
КОРЕНАСТЫЙ — КОРЕННОЙ — КОРНЕВОЙ
КОСТНЫЙ — КОСТЯНОЙ
КРАСОЧНЫЙ — КРАСЯЩИЙ — КРАШЕНЫЙ
ЛАКИРОВАННЫЙ –ЛАКИРОВОЧНЫЙ- ЛАКОВЫЙ
ЛЕДОВЫЙ — ЛЕДЯНОЙ
ЛЕСИСТЫЙ — ЛЕСНОЙ
ЛИЧНОСТНЫЙ — ЛИЧНЫЙ
МИКРОСКОПИЧЕСКИЙ — МИКРОСКОПИЧНЫЙ
МОРОЖЕНЫЙ — МОРОЗИЛЬНЫЙ — МОРОЗНЫЙ
НАБЛЮДАТЕЛЬНЫЙ — НАБЛЮДАТЕЛЬСКИЙ
НАДЕТЬ — ОДЕТЬ
НАЛИЧИЕ — НАЛИЧНОСТЬ
НАПОМИНАНИЕ — УПОМИНАНИЕ
НЕВЕЖА — НЕВЕЖДА
НЕСТЕРПИМЫЙ — НЕТЕРПЕЛИВЫЙ — НЕТЕРПИМЫЙ
НЕУДАЧНЫЙ — НЕУДАЧЛИВЫЙ
ОБВИНЁННЫЙ — ОБВИНИТЕЛЬНЫЙ
ОБРЫВОК — ОТРЫВОК
ОБСУДИТЬ — ОСУДИТЬ 
ОБХВАТИТЬ — ОХВАТИТЬ
ОГРАНИЧИТЬ — ОТГРАНИЧИТЬ — РАЗГРАНИЧИТЬ
ОКЛИК — ОТКЛИК
ОПАСЛИВЫЙ — ОПАСНЫЙ 
ОРГАНИЧЕСКИЙ — ОРГАНИЧНЫЙ
ОТБОРНЫЙ — ОТБОРОЧНЫЙ
ОТКЛОНЕНИЕ — УКЛОНЕНИЕ
ОТКЛОНИТЬСЯ — УКЛОНИТЬСЯ
ОТЛИЧАТЬ (-СЯ) — РАЗЛИЧАТЬ (-СЯ)
ОТЛИЧИЕ — РАЗЛИЧИЕ
ПАМЯТЛИВЫЙ — ПАМЯТНЫЙ
ПЕРЕТЕРПЕТЬ — ПРЕТЕРПЕТЬ
ПОКУПАТЕЛЬНЫЙ — ПОКУПАТЕЛЬСКИЙ — ПОКУПНОЙ
ПОНЯТЛИВЫЙ — ПОНЯТНЫЙ
ПОПУЛИСТСКИЙ — ПОПУЛЯРНЫЙ
ПОСТУПОК — ПРОСТУПОК
ПОЧТЕННЫЙ — ПОЧТИТЕЛЬНЫЙ — ПОЧЁТНЫЙ
ПРАЗДНИЧНЫЙ — ПРАЗДНЫЙ 
ПРАКТИЧЕСКИЙ — ПРАКТИЧНЫЙ
ПРЕДОСТАВИТЬ — ПРЕДСТАВИТЬ
ПРЕДСТАВИТЕЛЬНЫЙ — ПРЕДСТАВИТЕЛЬСКИЙ
ПРИЗНАННЫЙ — ПРИЗНАТЕЛЬНЫЙ
ПОДДЕЛКА — ПОДЕЛКА — ПРОДЕЛКА 
ПРОДУКТИВНЫЙ — ПРОДУКТОВЫЙ
ПРОИЗВОДИТЕЛЬНОСТЬ — ПРОИЗВОДСТВО
ПРОИЗВОДИТЕЛЬНЫЙ — ПРОЗВОДНЫЙ — ПРОИЗВОДСТВЕННЫЙ
ПРОСВЕТИТЕЛЬСКИЙ — ПРОСВЕЩЁННЫЙ
ПУБЛИЦИСТИЧЕСКИЙ — ПУБЛИЦИСТИЧНЫЙ
ПУГЛИВЫЙ — ПУГАНЫЙ
РАЗДРАЖЕНИЕ — РАЗДРАЖИТЕЛЬНОСТЬ
РАСЧЕТЛИВЫЙ — РАСЧЕТНЫЙ
РИТМИЧЕСКИЙ — РИТМИЧНЫЙ
РОМАНТИЧЕСКИЙ — РОМАНТИЧНЫЙ
СКЛАДНОЙ — СКЛАДСКОЙ 
СКРЫТНЫЙ — СКРЫТЫЙ
СЛОВАРНЫЙ — СЛОВЕСНЫЙ
СОПРОТИВЛЕНИЕ — СОПРОТИВЛЯЕМОСТЬ
СОСЕДНИЙ — СОСЕДСКИЙ
СРАВНИМЫЙ — СРАВНИТЕЛЬНЫЙ
СТЕКЛЯННЫЙ — СТЕКОЛЬНЫЙ 
СЦЕНИЧЕСКИЙ — СЦЕНИЧНЫЙ
СЫТНЫЙ — СЫТЫЙ
ТЕХНИЧЕСКИЙ — ТЕХНИЧНЫЙ
УДАЧЛИВЫЙ — УДАЧНЫЙ
УНИЖЕННЫЙ — УНИЗИТЕЛЬНЫЙ
ХИЩНИЧЕСКИЙ — ХИЩНЫЙ
ЦАРСКИЙ — ЦАРСТВЕННЫЙ — ЦАРСТВУЮЩИЙ
ЦЕЛЫЙ — ЦЕЛЬНЫЙ — ЦЕЛОСТНЫЙ
ЧЕЛОВЕЧНЫЙ — ЧЕЛОВЕЧЕСКИЙ
ЭКОНОМИКА — ЭКОНОМИЯ ЭКОНОМИЧЕСКИЙ — ЭКОНОМИЧНЫЙ — ЭКОНОМНЫЙ
ЭСТЕТИЧЕСКИЙ — ЭСТЕТИЧНЫЙ
ЭТИЧЕСКИЙ — ЭТИЧНЫЙ
ЭФФЕКТИВНЫЙ — ЭФФЕКТНЫЙ
ЭФФЕКТИВНОСТЬ — ЭФФЕКТНОСТЬ
ЯБЛОЧНЫЙ — ЯБЛОНЕВЫЙ
